




                                                                                ############


                                                                                                    ############




                                                                                                    ############
                                ############

                                                                            ########    ############            ######

                      ####                        ####

                                                                                                      ########   
          ####                                                  ####                                 #        #
                                                                                                    #          #
                                                                                                   ##############
 ####                                                                                               #          #
                                                                                                    #          #
                                                                                                    #          #
 ##                                                                                                 #          #